"well","id"
"A1","5"
"B1","4"
"C1","8"
"D1","8"
"E1","2"
"F1","8"
"G1"," "
"H1","9"
"A2","4"
"B2","7"
"C2","7"
"D2","1"
"E2"," "
"F2","1"
"G2","4"
"H2","1"
"A3","5"
"B3","6"
"C3"," "
"D3","9"
"E3","6"
"F3"," "
"G3","3"
"H3","3"
"A4","2"
"B4","7"
"C4","2"
"D4","3"
"E4"," "
"F4","6"
"G4","5"
"H4","9"
