"well","id"
"A1","4"
"B1","1"
"C1"," "
"D1","8"
"E1","6"
"F1"," "
"G1","3"
"H1","9"
"A2","8"
"B2","5"
"C2","7"
"D2","1"
"E2","5"
"F2","2"
"G2","2"
"H2","7"
"A3","4"
"B3","1"
"C3","3"
"D3"," "
"E3","4"
"F3","7"
"G3"," "
"H3","6"
"A4","3"
"B4"," "
"C4","2"
"D4","6"
"E4","5"
"F4","9"
"G4","8"
"H4","9"
