"well","id"
"A1","3"
"B1","2"
"C1"," "
"D1","2"
"E1","6"
"F1","10"
"G1","7"
"H1","7"
"A2","2"
"B2","9"
"C2","4"
"D2","4"
"E2","6"
"F2","7"
"G2","8"
"H2","9"
"A3","8"
"B3","1"
"C3","8"
"D3","5"
"E3","1"
"F3","9"
"G3","5"
"H3","4"
"A4","6"
"B4","3"
"C4","5"
"D4","10"
"E4","1"
"F4","3"
"G4"," "
"H4","10"
